########################################
#---------#----------------#---#---#---#
#-#-#-#-#-#-#-###-#-#-#-##-#-#-#-#-#-#-#
#-#-#-#-#-#-#-#---#-#-#--#-#-#-#-#-#-#-#
#-----------#-#-#-#-#--#-#---#---#-#-#-#
###########-#-#-#-#-##-#-#########-#-#-#
#------------------------------------#-#
#-#########-#-#-#-#-#-#-#-#-#-##-#-#-#-#
#-#---#---#-#-#-#-#-#-#-#-#-#--#-#-#---#
#---#---#-#-----#-------#----#------##-#
#########-#####-##-#########--#####--#-#
#------------------#---#---##-#---##---#
#-##########-#-#-#-#-#---#----#-#----#-#
#------------#-#-#-#-#######-##-######-#
#-##########-----------------------#---#
#------------#-##-#-#-##-#-#-#-#-#-#-###
#-##########-#----#-#--#-#-#-#-#-#-#---#
#-#---#---#---####---#-#-#-#-#-#-#-###-#
#---#---#---#------#-------------------#
########################################